5 5
WWWWW
W...W
W.B.W
WP..W
WWW.W